....#####..####
....#...#..#!!#
....#$..#..#!!#
..###..$##.#!!#
..#..$.$.#.#..#
###.#.##.#.#..#
#...#.##.###..#
#.$..$........#
#####.###.#@..#
....#.....#####
....#######....