.....#####..####
.....#...#..#!!#
.....#$..#..#!!#
...###..$##.#!!#
...#..$.$.#.#..#
.###.#.##.#.#..#
.#...#.##.###..#
.#.$..$........#
.#####.###.#@..#
.....#.....#####
.....#######.....
.