############
#!!..#.....###
#!!..#.$..$..#
#!!..#$####..#
#!!....@.##..#
#!!..#.#..$.##
######.##$.$.#
..#.$..$.$.$.#
..#....#.....#
..############