.
.############
.#!!..#.....###
.#!!..#.$..$..#
.#!!..#$####..#
.#!!....@.##..#
.#!!..#.#..$.##
.######.##$.$.#
...#.$..$.$.$.#
...#....#.....#
...############.
.