.#....#..####...
.#.$..####..#...
.#..$$.$...$#...
.###@.#$....##..
..#..##..$.$.##.
..#.$..##.##.!#.
..#..#$##$..#!#.
..###...$!!##!#.
...#....#!$!!!#.
...#.!!.#!!!!!#.
...#..#########.
...#..#.........