...#!!..#...#...
...#!!......#...
...#!!..#..####.
..#######..#..##
..#............#
..#..#..##..#..#
####.##..####.##
#..$..#####.#..#
#.#.$..$..#.$..#
#.@$..$...#...##
####.##.#######.
...#....#.......