.#####..........
.#!#!#..........
.#!!!########...
.#!!!#.....@#...
.#!!!#.$#$.##...
.#...#.$..$#....
.#...##$.$.#....
.##.##.$.#.####.
.#...#.$..$...#.
.#....$..$....#.
.#..###########.
.####...........