############...#
#....#..$.$....#
#.$$$#$..$.#...#
#..$.....$.#!!.#
#.$$.#$.$.$#!!!#
#..$.#.....#!!!#
##.#########!!!#
#....#....##!!!#
#.....$...##!!!#
#..$$#$$..@#!!!#
#....#....######
############....