......#####.....
......#...#####.
......#.#$##..#.
......#.....$.#.
#######.###...#.
#!!..##.$..$###.
#!!....$.$$.##..
#!!..##$..$.@#..
##!!..#..$..##..
.#!!..#.$.$..#..
.#!!..###.##.#..
.######.#....#..