................
.######..###....
.#!!..#.##@##...
.#!!..###...#...
.#!!.....$$.#...
.#!!..#.#.$.#...
.#!!###.#.$.#...
.####.$.#$..#...
....#..$..$.#...
....#.$..$..#...
....#..##...#...
....#########...