........#####...
..#######...##..
.##.#.@##.$$.#..
.#....$......#..
.#..$..###...#..
.###.#####$###..
.#.$..###.!!#...
.#.$.$.$..!!#...
.#....###!!!#...
.#.$$.#.#!!!#...
.#..###.#####...
.####...........