..#..###########
..#....$...$.$.#
..#.$#.$.#..$..#
..#..$.$..#....#
###.$#.#..####.#
#@#$.$.$..##...#
#....$.#$#...#.#
#...$....$.$.$.#
#####..#########
..#!!!!!!#......
..#!!!!!!#......
..#!!!!!!#......