.........#..!!!#
.....#####..!!!#
.....#......!.!#
.....#..##..!!!#
.....##.##..!!!#
....###.########
....#.$$$.##....
#####..$.$.#####
#...#$.$...#...#
#@$..$....$..$.#
#####.$$.$.#####
....#......#....