#..............#
#.#.######.....#
#.#..$.$.$.$#..#
#.#...$@$...#.##
#.#..$.$.$##!!!#
#.#...$.$..#!!!#
#.###$$$.$.#!!!#
#.....#.##.#!!!#
#####...##.#!!!#
....#####....###
........#....#..
........######..